11111111111111111111111111
10000C00000000000000000C01
1000000000C0000000C0000001
1P001100E01000000000000001
1000000000C0000000C0000001
1000C0000000000000C0000001
100000000000000000C0000001
11111111111111111111111111