1111111111111111111111111111111111111
1P000C0000000000000000000000000000001
1000000000000000000000C0CCCC000000001
10000000E000000000000C00000C000000001
10000000000000000000C00000C0000000001
1000000000000000000C00000C00000000001
100000000000000000CCCCC0CCCC000000001
1000000000000000000000C00000000000001
1000000000000000000000000000000000001
1000000011111111111111111100000000001
1000000000000000000000000010000000001
1000000000000000000000000001000000001
10CCCCCC00CCCCCC00CCCCCC0000100000001
10C0000000C0000C00C0000C0000010000001
10C0000000CCCCCC00C0000C0000010000001
10C0000000C0000C00C0000C0000100000001
10CCCCCC00C0000C00C0000C0001000000001
1000000000000000000000000000000000001
1111111111111111111111111111111111111